11111111111111111111
10030012222222003001
10030012000000003001
10110012000022001001
10010000000011111001
10010000000000003001
11012220000000003001
10010000000000001001
10011110010022001001
10110200010000021001
10010200010022021001
10030000010000021001
10030000010000001001
10011111113311111001
10010000000000001001
16116666666666666661
16666666666666666661
16666666666666666661
16666666666666666661
11111111111111111111