11111111111111111111
10000000000000000001
10000000000000000001
10011111133111111001
10010200000000001001
10010002200000003001
10010000000020003001
10010001100110001001
10010001000010001001
10030009000000001001
10030000000200001001
10012001000010003001
10010001100110003001
10010000000000021001
10010000000000001001
10011111133111111001
16666666666666666661
16666666666666666661
16666666666666666661
11111111111111111111